Posting data,Realization data,Partner's account,BIC,Partner's name,Amount,Currency,Partner's reference,Variable symbol,Specific symbol,Constant symbol,Additional information,Document number,Bulk payment batch ID,Balance
20130502,20130502,,,,"-10,00",EUR,,****9021,1130430334,4559,DDATM342C LM-OD PRIOR 4333125537,0205229078718,,"32,47"
20130503,20130503,,,,"-20,00",EUR,,****9021,1130502334,4559,DDATM342A LM - VUB    4333134200,0305229003649,,"12,47"
20130520,20130520,,,,"-8,49",EUR,,****9021,2130517334,0608,DDCOOP LIPTOVSKY MIKU 4333000000,2005229265136,,"3,98"
20130628,20130627,,,,"100,00",EUR,,9,,0968,asdasdasdasddasdasd,280600003048N,,"103,98"
20130701,20130701,,,,"-1,20",EUR,,7377373737,130629994,0898,RB Prazskeho povstan P,0107229307409,,"102,78"
20130701,20130701,,,,"-13,44",EUR,,****9021,2130628994,0608,ALBERT 0531         43,0107229220164,,"89,34"
20130701,20130701,,,,"-15,40",EUR,,****9021,130629994,4559,RB Prazskeho povstan43,0107229307408,,"73,94"
20130703,20130703,,,,"-2,54",EUR,,****9021,2130630994,0608,BILLA S.R.O.        43,0307229126106,,"71,40"
20130703,20130703,,,,"-5,15",EUR,,****9021,2130630994,0608,INTERSPAR PRAHA-HARF43,0307229126469,,"66,25"
20130703,20130703,,,,"-8,31",EUR,,****9021,2130629994,0608,INTERSPAR PRAHA-HARF43,0307229126471,,"57,94"
20130703,20130703,,,,"-10,00",EUR,,****9021,1130702334,4559,ATM342C LM-OD PRIOR 43,0307229036686,,"47,94"
20130708,20130708,,,,"-16,23",EUR,,****9021,2130702334,0608,COOP Jednota Zarnovi43,0807229080655,,"31,71"
20130709,20130709,,,,"-10,00",EUR,,****9021,1130708334,4559,ATM342C LM-OD PRIOR 43,0907229021647,,"21,71"
20130717,20130717,,,,"-3,87",EUR,,****9021,2130715334,0608,COOP LIPTOVSKY MIKU 43,1707229091636,,"17,84"
20130719,20130719,,,,"-2,80",EUR,,****9021,2130717334,0608,COOP LIPTOVSKY MIKU 43,1907229095017,,"15,04"
20130725,20130725,,,,"-10,00",EUR,,****9021,1130724334,4559,ATM342A LM - VUB    43,2507229021977,,"5,04"
20130916,20130916,,,,"600,00",EUR,,9,,0968,asdasdasdasddasdasd,160900042330N,,"605,04"
20130917,20130917,,,,"120,00",EUR,,9,,,platba za sluzbicky,170900062655N,,"725,04"
20130917,20130917,,,,"-1,20",EUR,,7377373737,130916994,0898,RB Hlavni nadrazi II,1709229070116,,"723,84"
20130917,20130917,,,,"-505,36",EUR,,****9021,130916994,4559,RB Hlavni nadrazi II,1709229070115,,"218,48"
20130923,20130923,,,,"-55,00",EUR,,9,,0968,platba za internet,220913N002IZR,,"163,48"
20131002,20131002,,,,"-11,67",EUR,,****9021,2130930994,0608,SLEVOMAT CZ,0210229072373,,"151,81"
20131003,20131003,,,,"-7,45",EUR,,****9021,2130930994,0608,INTERSPAR ARKADY,0310229070741,,"144,36"
20131004,20131004,,,,"-13,16",EUR,,****9021,2131001994,0608,INTERSPAR ARKADY,0410229060919,,"131,20"
20131007,20131007,,,,"-7,74",EUR,,****9021,2131003994,0608,INTERSPAR ARKADY,0710229223595,,"123,46"
20131009,20131009,,,,"-10,66",EUR,,****9021,2131006994,0608,INTERSPAR ARKADY,0910229074785,,"112,80"
20131010,20131010,,,,"-6,55",EUR,,****9021,2131007994,0608,INTERSPAR ARKADY,1010229075011,,"106,25"
20131011,20131011,,,,"-15,20",EUR,,****9021,2131008334,0608,"STUDENT AGENCY, K.S.",1110229081966,,"91,05"
20131014,20131014,,,,"300,00",EUR,,9,,0968,asdasdasdasddasdasd,141013R01G7MR,,"391,05"
20131014,20131014,,,,"-1,20",EUR,,7377373737,131011994,0898,S6CY PHA4 METRO PRAZ,1410229103738,,"389,85"
20131014,20131014,,,,"-78,59",EUR,,****9021,131011994,4559,S6CY PHA4 METRO PRAZ,1410229103737,,"311,26"
20131016,20131016,,,,"-1,20",EUR,,7377373737,131015994,0898,S6CY PHA4 METRO PRAZ,1610229091717,,"310,06"
20131016,20131016,,,,"-196,45",EUR,,****9021,131015994,4559,S6CY PHA4 METRO PRAZ,1610229091716,,"113,61"
20131018,20131018,,,,"-3,91",EUR,,****9021,2131016994,0608,PERFECT SYSTEM,1810229089237,,"109,70"
20131021,20131021,,,,"110,00",EUR,,9,,0968,vklad na ucet,211013R010VFR,,"219,70"
20131021,20131021,,,,"-7,79",EUR,,****9021,2131017994,0608,T-MOBILE CZECH REPUB,2110229223252,,"211,91"
20131021,20131021,,,,"-10,23",EUR,,****9021,2131016994,0608,PRODEJNI MISTO I.P.P,2110229075030,,"201,68"
20131021,20131021,,,,"-10,25",EUR,,****9021,2131017994,0608,INTERSPAR ARKADY,2110229238364,,"191,43"
20131021,20131021,,,,"-39,30",EUR,,****9021,2131017994,0608,TESCO PRAHA 4-NUSLE,2110229238181,,"152,13"
20131024,20131024,,,,"-9,54",EUR,,****9021,2131021994,0608,INTERSPAR ARKADY,2410229076893,,"142,59"
20131025,20131025,,,,"-1,20",EUR,,7377373737,131023994,0898,NA PANKRACI 86 ARKAD,2510229081066,,"141,39"
20131025,20131025,,,,"-16,39",EUR,,****9021,2131022994,0608,INTERSPAR ARKADY,2510229076772,,"125,00"
20131025,20131025,,,,"-38,90",EUR,,****9021,131023994,4559,NA PANKRACI 86 ARKAD,2510229081065,,"86,10"
20131028,20131028,,,,"-4,40",EUR,,****9021,2131025334,0608,ZELEZNICNA SPOL  SLO,2810229220266,,"81,70"
20131028,20131028,,,,"-15,20",EUR,,****9021,2131025334,0608,"STUDENT AGENCY, K.S.",2810229328055,,"66,50"
20131106,20131106,,,,"-1,20",EUR,,7377373737,131104994,0898,"CS, NAR.TECH.KNIHOVN",0611229060101,,"65,30"
20131106,20131106,,,,"-12,35",EUR,,****9021,2131103994,0608,INTERSPAR ARKADY,0611229070932,,"52,95"
20131106,20131106,,,,"-38,90",EUR,,****9021,131104994,4559,"CS, NAR.TECH.KNIHOVN",0611229060100,,"14,05"
20131118,20131118,,,,"300,00",EUR,,9,,0968,asdasdasdasddasdasd,181113R004RWR,,"314,05"
20131118,20131118,,,,"-1,20",EUR,,7377373737,131115994,0898,"CS, METRO I.P. PAVLO",1811229365648,,"312,85"
20131118,20131118,,,,"-7,39",EUR,,****9021,131115994,4559,"CS, METRO I.P. PAVLO",1811229365647,,"305,46"
20131120,20131120,,,,"-1,20",EUR,,7377373737,131118994,0898,S6CY PHA4 METRO PRAZ,2011229093121,,"304,26"
20131120,20131120,,,,"-9,61",EUR,,****9021,2131118994,0608,PRODEJNI MISTO I.P.P,2011229085585,,"294,65"
20131120,20131120,,,,"-147,88",EUR,,****9021,131118994,4559,S6CY PHA4 METRO PRAZ,2011229093120,,"146,77"
20131121,20131121,,,,"-14,00",EUR,,****9021,2131118994,0608,INTERSPAR ARKADY,2111229082536,,"132,77"
20131125,20131125,,,,"110,00",EUR,,9,,0968,vklad na ucet,251113R00211R,,"242,77"
20131125,20131125,,,,"-1,20",EUR,,7377373737,131122994,0898,S6CY PHA4 METRO PRAZ,2511229248396,,"241,57"
20131125,20131125,,,,"-36,91",EUR,,****9021,131122994,4559,S6CY PHA4 METRO PRAZ,2511229248395,,"204,66"
20131202,20131202,,,,"-4,72",EUR,,****9021,2131130994,0608,DAMEJIDLO.CZ,0212229343700,,"199,94"
20131202,20131202,,,,"-8,94",EUR,,****9021,2131127994,0608,INTERSPAR ARKADY,0212229100441,,"191,00"
20131203,20131203,,,,"-1,20",EUR,,7377373737,131201994,0898,S6CY PHA4 METRO PRAZ,0312229062522,,"189,80"
20131203,20131203,,,,"-73,25",EUR,,****9021,131201994,4559,S6CY PHA4 METRO PRAZ,0312229062521,,"116,55"
20131209,20131209,,,,"-1,20",EUR,,7377373737,131204994,0898,"CS, CENTROTEX",0912229085537,,"115,35"
20131209,20131209,,,,"-14,10",EUR,,****9021,2131205994,0608,INTERSPAR ARKADY,0912229250157,,"101,25"
20131209,20131209,,,,"-73,25",EUR,,****9021,131204994,4559,"CS, CENTROTEX",0912229085536,,"28,00"
20131216,20131216,,,,"300,00",EUR,,9,,0968,asdasdasdasddasdasd,161213R00TKER,,"328,00"
20131216,20131216,,,,"-9,53",EUR,,****9021,2131212994,0608,INTERSPAR ARKADY,1612229299790,,"318,47"
20131216,20131216,,,,"-36,00",EUR,,9,,0968,Vyrovnanie Davidko,161213N01UY2R,,"282,47"
20131219,20131219,,,,"-1,20",EUR,,7377373737,131217994,0898,S6CY PHA4 METRO PRAZ,1912229133448,,"281,27"
20131219,20131219,,,,"-4,33",EUR,,****9021,2131216994,0608,INTERSPAR ARKADY,1912229122819,,"276,94"
20131219,20131219,,,,"-145,04",EUR,,****9021,131217994,4559,S6CY PHA4 METRO PRAZ,1912229133447,,"131,90"
20131220,20131220,,,,"-9,41",EUR,,****9021,2131218994,0608,SDI MUZEUM,2012229110505,,"122,49"
20131223,20131223,,,,"-5,68",EUR,,****9021,2131220994,0608,BILLA S.R.O.,2312229310944,,"116,81"
20131223,20131223,,,,"-10,00",EUR,,****9021,1131221334,4559,ATM342C LM-OD PRIOR,2312229369265,,"106,81"
20131223,20131223,,,,"-11,00",EUR,,****9021,2131220334,0608,ZELEZNICNA SPOL  SLO,2312229296409,,"95,81"
20131223,20131223,,,,"-14,05",EUR,,****9021,2131218994,0608,INTERSPAR ARKADY,2312229128331,,"81,76"
20131223,20131223,,,,"-19,95",EUR,,****9021,2131221334,0608,MINECRAFT.NET,2312229443275,,"61,81"
20131227,20131227,,,,"-20,00",EUR,,****9021,1131225334,4559,ATM342A LM - VUB,2712229442481,,"41,81"
20140107,20140105,,,,"110,00",EUR,,9,,0968,asdasdasdasddasdasd,050114R005NRR,,"151,81"
20140107,20140107,,,,"-1,20",EUR,,7377373737,140103994,0898,"CS, CENTROTEX",0701229244575,,"150,61"
20140107,20140103,,,,"-14,59",EUR,,****9021,140103994,4559,"CS, CENTROTEX",0701229244574,,"136,02"
20140107,20140107,,,,"-20,00",EUR,,****9021,2140102334,0608,SLOVNAFT  A S,0701229068852,,"116,02"
20140108,20140108,,,,"-1,20",EUR,,7377373737,140106994,0898,NA PANKRACI 86 ARKAD,0801229119950,,"114,82"
20140108,20140106,,,,"-72,92",EUR,,****9021,140106994,4559,NA PANKRACI 86 ARKAD,0801229119949,,"41,90"
20140113,20140113,,,,"-13,12",EUR,,****9021,2140111994,0608,DAMEJIDLO.CZ,1301229312142,,"28,78"
20140116,20140116,,,,"300,00",EUR,,9,,0968,asdasdasdasddasdasd,160114R01548R,,"328,78"
20140120,20140120,,,,"-1,20",EUR,,7377373737,140117994,0898,S6CY PHA4 METRO PRAZ,2001229261007,,"327,58"
20140120,20140117,,,,"-36,55",EUR,,****9021,140117994,4559,S6CY PHA4 METRO PRAZ,2001229261006,,"291,03"
20140123,20140123,,,,"-1,20",EUR,,7377373737,140121994,0898,S6CY PHA4 METRO PRAZ,2301229113480,,"289,83"
20140123,20140121,,,,"-145,76",EUR,,****9021,140121994,4559,S6CY PHA4 METRO PRAZ,2301229113479,,"144,07"
20140124,20140124,,,,"-9,47",EUR,,****9021,2140122994,0608,SDI MUZEUM,2401229078753,,"134,60"
20140127,20140127,,,,"110,00",EUR,,9,,0968,asdasdasdasddasdasd-ubyt,270114R00U9VR,,"244,60"
20140127,20140127,,,,"-14,56",EUR,,****9021,2140125994,0608,DATART INTERNATIONAL,2701229308682,,"230,04"
20140127,20140127,,,,"-15,19",EUR,,****9021,2140122994,0608,INTERSPAR ARKADY,2701229086875,,"214,85"
20140127,20140127,,,,"-22,90",EUR,,****9021,2140124994,0608,INTERSPAR ARKADY,2701229308676,,"191,95"
20140128,20140128,,,,"-7,70",EUR,,****9021,2140125994,0608,INTERSPAR ARKADY,2801229111465,,"184,25"
20140129,20140129,,,,"-8,22",EUR,,****9021,2140126994,0608,"C&A MODA, S.R.O.",2901229076574,,"176,03"
20140131,20140131,,,,"-10,43",EUR,,****9021,2140128994,0608,INTERSPAR ARKADY,3101229055481,,"165,60"
20140203,20140203,,,,"-1,20",EUR,,7377373737,140130994,0898,"CS, OC ARKADY",0302IG0000001,,"164,40"
20140203,20140130,,,,"-20,88",EUR,,****9021,2140130994,0608,INTERSPAR ARKADY,0302229229518,,"143,52"
20140203,20140130,,,,"-72,77",EUR,,****9021,140130994,4559,"CS, OC ARKADY",0302229094314,,"70,75"
20140206,20140203,,,,"-14,10",EUR,,****9021,2140203994,0608,INTERSPAR ARKADY,0602229071253,,"56,65"
20140207,20140205,,,,"-2,20",EUR,,****9021,2140205334,0608,ZELEZNICNA SPOL  SLO,0702229064368,,"54,45"
20140217,20140217,SK32423749823947823742988,SUBASKBX,adkskjdhkashdkjashd,"300,00",EUR,/VS/SS/KS968,,,0968,asdasdasdasddasdasd,1402171AJQIBR,,"354,45"
20140217,20140214,,,,"-3,10",EUR,,****9021,2140214334,0608,ZELEZNICNA SPOL  SLO,1702229262097,,"351,35"
20140217,20140214,,,,"-10,00",EUR,,****9021,1140214334,4559,ATM342J LM-ZSR STAN,1702229050580,,"341,35"
20140220,20140220,,,,"-1,20",EUR,,7377373737,140218994,0898,NA PANKRACI 86 ARKAD,2002229091290,,"340,15"
20140220,20140218,,,,"-109,94",EUR,,****9021,140218994,4559,NA PANKRACI 86 ARKAD,2002229091289,,"230,21"
20140221,20140218,,,,"-13,40",EUR,,****9021,2140218994,0608,INTERSPAR ARKADY,2102229085113,,"216,81"
20140224,20140221,,,,"-9,53",EUR,,****9021,2140221994,0608,SDI MUZEUM,2402229334751,,"207,28"
20140224,20140221,,,,"-13,69",EUR,,****9021,2140221994,0608,INTERSPAR ARKADY,2402229334831,,"193,59"
20140225,20140222,,,,"-5,07",EUR,,****9021,2140222994,0608,TESCO PRAHA 4-NUSLE,2502229123690,,"188,52"
20140227,20140227,,,,"-1,20",EUR,,7377373737,140225994,0898,"CS, NAR.TECH.KNIHOVN",2702229068202,,"187,32"
20140227,20140224,,,,"-31,37",EUR,,****9021,2140224994,0608,INTERSPAR ARKADY,2702229080198,,"155,95"
20140227,20140225,,,,"-36,72",EUR,,****9021,140225994,4559,"CS, NAR.TECH.KNIHOVN",2702229068201,,"119,23"
20140228,20140228,SK32423749823947823742988,SUBASKBX,adkskjdhkashdkjashd,"100,00",EUR,/VS/SS/KS968,,,0968,asdasdasdasddasdasd,1402280R8MIBR,,"219,23"
20140303,20140226,,,,"-21,81",EUR,,****9021,2140226994,0608,INTERSPAR ARKADY,0303229092739,,"197,42"
20140304,20140304,FIO832478923749823748,FIOZSKBAXXX,NOTPROVIDED,"-52,00",EUR,/VS9/SS/KS968,9,,0968,platba za internet,1403031J6ZIBR,,"145,42"
20140304,20140304,,,,"-1,20",EUR,,7377373737,140228994,0898,NA PANKRACI 86 ARKAD,0403229122610,,"144,22"
20140304,20140228,,,,"-36,92",EUR,,****9021,140228994,4559,NA PANKRACI 86 ARKAD,0403229122609,,"107,30"
20140306,20140306,,,,"-1,20",EUR,,7377373737,140304994,0898,"CS, NAR.TECH.KNIHOVN",0603229065485,,"106,10"
20140306,20140303,,,,"-8,32",EUR,,****9021,2140303994,0608,INTERSPAR ARKADY,0603229076441,,"97,78"
20140306,20140304,,,,"-36,72",EUR,,****9021,140304994,4559,"CS, NAR.TECH.KNIHOVN",0603229065484,,"61,06"
20140310,20140307,,,,"-13,50",EUR,,****9021,2140307994,0608,INTERSPAR ARKADY,1003229348455,,"47,56"
20140311,20140308,,,,"-17,69",EUR,,****9021,2140308994,0608,INTERSPAR ARKADY,1103229133326,,"29,87"
20140313,20140313,,,,"-1,20",EUR,,7377373737,140311994,0898,"CS, NAR.TECH.KNIHOVN",1303229082680,,"28,67"
20140313,20140311,,,,"-18,36",EUR,,****9021,140311994,4559,"CS, NAR.TECH.KNIHOVN",1303229082679,,"10,31"
20140318,20140318,SK32423749823947823742988,SUBASKBX,adkskjdhkashdkjashd,"300,00",EUR,/VS/SS/KS968,,,0968,asdasdasdasddasdasd,1403180YH0IBR,,"310,31"
20140320,20140320,,,,"-1,20",EUR,,7377373737,140318994,0898,"CS, NAR.TECH.KNIHOVN",2003229077011,,"309,11"
20140320,20140318,,,,"-183,24",EUR,,****9021,140318994,4559,"CS, NAR.TECH.KNIHOVN",2003229077010,,"125,87"
20140324,20140320,,,,"-7,31",EUR,,****9021,2140320994,0608,T-MOBILE CZECH REPUB,2403229234140,,"118,56"
20140324,20140320,,,,"-9,50",EUR,,****9021,2140320994,0608,PRODEJNI MISTO I.P.P,2403229250677,,"109,06"
20140324,20140319,,,,"-23,19",EUR,,****9021,2140319994,0608,INTERSPAR ARKADY,2403229102449,,"85,87"
20140326,20140323,,,,"-17,34",EUR,,****9021,2140323994,0608,INTERSPAR ARKADY,2603229086126,,"68,53"
20140328,20140328,SK32423749823947823742988,SUBASKBX,adkskjdhkashdkjashd,"100,00",EUR,/VS/SS/KS968,,,0968,asdasdasdasddasdasd,1403280Z9AIBR,,"168,53"
20140331,20140328,,,,"-14,00",EUR,,****9021,2140328994,0608,INTERSPAR ARKADY,3103229343229,,"154,53"
20140402,20140330,,,,"-19,98",EUR,,****9021,2140330994,0608,INTERSPAR ARKADY,0204229082072,,"134,55"
20140403,20140403,,,,"-1,20",EUR,,7377373737,140401994,0898,S6CY PHA4 METRO PRAZ,0304229086474,,"133,35"
20140403,20140401,,,,"-36,59",EUR,,****9021,140401994,4559,S6CY PHA4 METRO PRAZ,0304229086473,,"96,76"
20140404,20140401,,,,"-7,42",EUR,,****9021,2140401994,0608,INTERSPAR ARKADY,0404229078686,,"89,34"
20140407,20140407,,,,"-1,20",EUR,,7377373737,140405994,0898,S6CY PHA4 METRO PRAZ,0704229336936,,"88,14"
20140407,20140403,,,,"-11,97",EUR,,****9021,2140403994,0608,ALBERT HM 0198,0704229099003,,"76,17"
20140407,20140403,,,,"-15,39",EUR,,****9021,2140403994,0608,INTERSPAR ARKADY,0704229232811,,"60,78"
20140407,20140405,,,,"-36,62",EUR,,****9021,140405994,4559,S6CY PHA4 METRO PRAZ,0704229336935,,"24,16"
20140408,20140405,,,,"-16,68",EUR,,****9021,2140405994,0608,INTERSPAR ARKADY,0804229125266,,"7,48"
20140411,20140408,,,,"-4,12",EUR,,****9021,2140408994,0608,TESCO PRAHA 4-NUSLE,1104229093499,,"3,36"
20140417,20140417,SK32423749823947823742988,SUBASKBX,adkskjdhkashdkjashd,"300,00",EUR,/VS/SS/KS968,,,0968,asdasdasdasddasdasd,14041715XPIBR,,"303,36"
20140422,20140422,,,,"-1,20",EUR,,7377373737,140418994,0898,S6CY PHA4 METRO PRAZ,2204229295803,,"302,16"
20140422,20140422,,,,"-1,20",EUR,,7377373737,140418994,0898,S6CY PHA4 METRO PRAZ,2204229435546,,"300,96"
20140422,20140420,,,,"-9,43",EUR,,****9021,2140420994,0608,PEPA.CZ,2204229565122,,"291,53"
20140422,20140418,,,,"-36,55",EUR,,****9021,140418994,4559,S6CY PHA4 METRO PRAZ,2204229435545,,"254,98"
20140422,20140418,,,,"-109,66",EUR,,****9021,140418994,4559,S6CY PHA4 METRO PRAZ,2204229295802,,"145,32"
20140423,20140420,,,,"-3,52",EUR,,****9021,2140420994,0608,TESCO PRAHA 4-NUSLE,2304229057315,,"141,80"
20140425,20140422,,,,"-9,51",EUR,,****9021,2140422994,0608,SDI MUZEUM,2504229086419,,"132,29"
20140428,20140428,,,,"-1,20",EUR,,7377373737,140426994,0898,"CS, CENTROTEX",2804229324924,,"131,09"
20140428,20140425,,,,"-12,21",EUR,,****9021,2140425994,0608,TESCO PRAHA 4-NUSLE,2804229336837,,"118,88"
20140428,20140425,,,,"-13,90",EUR,,****9021,2140425994,0608,TESCO PRAHA 4-NUSLE,2804229336836,,"104,98"
20140428,20140426,,,,"-36,61",EUR,,****9021,140426994,4559,"CS, CENTROTEX",2804229324923,,"68,37"
20140429,20140429,SK32423749823947823742988,SUBASKBX,adkskjdhkashdkjashd,"100,00",EUR,/VS/SS/KS968,,,0968,asdasdasdasddasdasd,14042910E9IBR,,"168,37"
20140430,20140427,,,,"-2,93",EUR,,****9021,2140427994,0608,"STUDENT AGENCY, K.S.",3004229086384,,"165,44"
20140430,20140427,,,,"-9,35",EUR,,****9021,2140427994,0608,"STUDENT AGENCY, K.S.",3004229086374,,"156,09"
20140502,20140430,,,,"-4,40",EUR,,****9021,2140430334,0608,ELE NICNA SPOL  SLO,0205229206438,,"151,69"
20140502,20140429,,,,"-8,33",EUR,,****9021,2140429994,0608,INTERSPAR ARKADY,0205229219535,,"143,36"
20140505,20140430,,,,"-2,20",EUR,,****9021,2140430994,0608,TESCO PRAHA 4-NUSLE,0505229113135,,"141,16"
20140505,20140502,,,,"-10,00",EUR,,****9021,1140502334,4559,ATM342N LM-OC JASNA,0505229181614,,"131,16"
20140506,20140506,,,,"-1,20",EUR,,7377373737,140504994,0898,S6CY PHA4 METRO PRAZ,0605229131195,,"129,96"
20140506,20140504,,,,"-21,00",EUR,,****9021,2140504334,0608,ELE NICNA SPOL  SLO,0605229117170,,"108,96"
20140506,20140504,,,,"-36,65",EUR,,****9021,140504994,4559,S6CY PHA4 METRO PRAZ,0605229131194,,"72,31"
20140509,20140506,,,,"-6,53",EUR,,****9021,2140506994,0608,INTERSPAR ARKADY,0905229227962,,"65,78"
20140512,20140512,,,,"-1,20",EUR,,7377373737,140510994,0898,"CS, METRO PANKRAC (C",1205229389996,,"64,58"
20140512,20140509,,,,"-3,26",EUR,,****9021,2140509994,0608,TESCO PRAHA 4-NUSLE,1205229404172,,"61,32"
20140512,20140510,,,,"-36,72",EUR,,****9021,140510994,4559,"CS, METRO PANKRAC (C",1205229389995,,"24,60"
20140516,20140516,SK32423749823947823742988,SUBASKBX,adkskjdhkashdkjashd,"300,00",EUR,/VS/SS/KS968,,,0968,asdasdasdasddasdasd,14051612INIBR,,"324,60"
20140516,20140514,,,,"-7,29",EUR,,****9021,2140514994,0608,MCDONALDS,1605229084070,,"317,31"
20140519,20140519,,,,"-1,20",EUR,,7377373737,140517994,0898,S6CY PHA4 METRO PRAZ,1905229405506,,"316,11"
20140519,20140514,,,,"-1,46",EUR,,****9021,2140514994,0608,TESCO PRAHA 4-NUSLE,1905229114392,,"314,65"
20140519,20140517,,,,"-146,54",EUR,,****9021,140517994,4559,S6CY PHA4 METRO PRAZ,1905229405505,,"168,11"
20140521,20140518,,,,"-4,38",EUR,,****9021,2140518994,0608,TESCO PRAHA 4-NUSLE,2105229094498,,"163,73"
20140526,20140525,SK8394839484939483849384,SUBASKBXXXX,asdasdasdasdasd,"-40,00",EUR,NOTPROVIDED,,,,,1405250KGUIBR,,"123,73"
20140526,20140526,,,,"-1,20",EUR,,7377373737,140523994,0898,"CS, NAR.TECH.KNIHOVN",2605229243079,,"122,53"
20140526,20140523,,,,"-9,52",EUR,,****9021,2140523994,0608,SDI MUZEUM,2605229366385,,"113,01"
20140526,20140523,,,,"-36,61",EUR,,****9021,140523994,4559,"CS, NAR.TECH.KNIHOVN",2605229243078,,"76,40"
20140528,20140525,,,,"-12,77",EUR,,****9021,2140525994,0608,INTERSPAR ARKADY,2805229087679,,"63,63"
20140602,20140602,SK32423749823947823742988,SUBASKBX,adkskjdhkashdkjashd,"100,00",EUR,/VS/SS/KS968,,,0968,asdasdasdasddasdasd,1406020H5YIBR,,"163,63"
20140602,20140602,,,,"-1,20",EUR,,7377373737,140530994,0898,S6CY PHA4 METRO PRAZ,0206229251135,,"162,43"
20140602,20140530,,,,"-36,53",EUR,,****9021,140530994,4559,S6CY PHA4 METRO PRAZ,0206229251134,,"125,90"
20140605,20140602,,,,"-5,31",EUR,,****9021,2140602994,0608,INTERSPAR ARKADY,0506229081538,,"120,59"
20140606,20140603,,,,"-17,34",EUR,,****9021,2140603994,0608,INTERSPAR ARKADY,0606229082675,,"103,25"
20140609,20140609,,,,"-1,20",EUR,,7377373737,140605994,0898,"CS, PLAV.ST. PODOLI",0906229087057,,"102,05"
20140609,20140605,,,,"-4,21",EUR,,****9021,2140605994,0608,INTERSPAR ARKADY,0906229250218,,"97,84"
20140609,20140605,,,,"-10,52",EUR,,****9021,2140605994,0608,INTERSPAR ARKADY,0906229250219,,"87,32"
20140609,20140605,,,,"-36,71",EUR,,****9021,140605994,4559,"CS, PLAV.ST. PODOLI",0906229087056,,"50,61"
20140611,20140608,,,,"-3,30",EUR,,****9021,2140608994,0608,TESCO PRAHA 4-NUSLE,1106229099245,,"47,31"
20140616,20140616,SK32423749823947823742988,SUBASKBX,adkskjdhkashdkjashd,"300,00",EUR,/VS/SS/KS968,,,0968,asdasdasdasddasdasd,1406160932IBR,,"347,31"
20140616,20140612,,,,"-7,23",EUR,,****9021,2140612994,0608,TESCO PRAHA 4-NUSLE,1606229301014,,"340,08"
20140616,20140612,,,,"-7,50",EUR,,****9021,2140612994,0608,INTERSPAR ARKADY,1606229301251,,"332,58"
20140616,20140614,,,,"-13,12",EUR,,****9021,2140614994,0608,SLEVOMAT CZ,1606229427896,,"319,46"
20140619,20140617,,,,"-5,00",EUR,,****9021,2140617334,0608,STEAMGAMES.COM,1906229096306,,"314,46"
20140623,20140623,,,,"-1,20",EUR,,7377373737,140618994,0898,"CS, OC ARKADY",2306229127970,,"313,26"
20140623,20140618,,,,"-91,37",EUR,,****9021,140618994,4559,"CS, OC ARKADY",2306229127969,,"221,89"
20140627,20140624,,,,"-9,54",EUR,,****9021,2140624994,0608,SDI MUZEUM,2706229114189,,"212,35"
20140630,20140630,,,,"-1,20",EUR,,7377373737,140626994,0898,"CS, CENTROTEX",3006229090899,,"211,15"
20140630,20140630,,,,"-1,20",EUR,,7377373737,140627994,0898,NA LYSINE 772/12,3006229110417,,"209,95"
20140630,20140628,,,,"-10,00",EUR,,****9021,1140628334,4559,ATM342A LM - VUB,3006229314102,,"199,95"
20140630,20140627,,,,"-14,66",EUR,,****9021,140627994,4559,NA LYSINE 772/12,3006229110416,,"185,29"
20140630,20140625,,,,"-15,45",EUR,,****9021,2140625994,0608,TESCO PRAHA 4-NUSLE,3006229106626,,"169,84"
20140630,20140626,,,,"-36,64",EUR,,****9021,140626994,4559,"CS, CENTROTEX",3006229090898,,"133,20"
20140701,20140627,,,,"-5,60",EUR,,****9021,2140627994,0608,BB ARKADY,0107229120584,,"127,60"
20140707,20140704,,,,"-29,72",EUR,,****9021,2140704334,0608,DM LIPTOVSK� MIKUL��,0707229146860,,"97,88"
20140708,20140707,,,,"-10,00",EUR,,****9021,1140707334,4559,ATM342J LM-ZSR STAN,0807229018964,,"87,88"
20140708,20140704,,,,"-15,09",EUR,,****9021,2140704334,0608,"KAUFLAND, LM, DEMANO",0807229073335,,"72,79"
20140709,20140707,,,,"-7,99",EUR,,****9021,2140707334,0608,"DM, LM, NAM. 1. MAJA",0907229059914,,"64,80"
20140709,20140708,,,,"-11,80",EUR,,****9021,2140708334,0608,GOOD MOOD PIZZA & BA,0907229174891,,"53,00"
20140728,20140725,,,,"-3,08",EUR,,****9021,2140725334,0608,BILLA  SPOL  S R O,2807229238965,,"49,92"
20140731,20140729,,,,"-19,95",EUR,,****9021,2140729334,0608,MINECRAFT.NET,3107229086903,,"29,97"
20140804,20140731,,,,"-6,88",EUR,,****9021,2140731334,0608,COOP LIPTOVSKY MIKU,0408229115608,,"23,09"
20140903,20140903,SK32423749823947823742988,SUBASKBX,adkskjdhkashdkjashd,"300,00",EUR,/VS/SS/KS968,,,0968,asdasdasdasddasdasd,1409030Y14IBR,,"323,09"
20140904,20140904,SK32423749823947823742988,SUBASKBX,adkskjdhkashdkjashd,"140,00",EUR,/VS/SS/KS968,,,0968,asdasdasdasddasdasd,14090418ICIBR,,"463,09"
20140905,20140905,,,,"-1,20",EUR,,7377373737,140904994,0898,NA LYSINE 772/12,0509229090520,,"461,89"
20140905,20140904,,,,"-145,30",EUR,,****9021,140904994,4559,NA LYSINE 772/12,0509229090519,,"316,59"
20140908,20140904,,,,"-25,16",EUR,,****9021,2140904994,0608,INTERSPAR ARKADY,0809229246080,,"291,43"
20140909,20140909,,,,"-1,20",EUR,,7377373737,140908994,0898,140 00 Roztylska,0909229127479,,"290,23"
20140909,20140907,,,,"-20,10",EUR,,****9021,2140907994,0608,SDI MUZEUM,0909229126173,,"270,13"
20140909,20140908,,,,"-36,54",EUR,,****9021,140908994,4559,140 00 Roztylska,0909229127478,,"233,59"
20140911,20140911,,,,"-1,20",EUR,,7377373737,140909994,0898,"CS, PLAV.ST. PODOLI",1109229081554,,"232,39"
20140911,20140909,,,,"-36,49",EUR,,****9021,140909994,4559,"CS, PLAV.ST. PODOLI",1109229081553,,"195,90"
20140912,20140909,,,,"-27,00",EUR,,****9021,2140909994,0608,INTERSPAR ARKADY,1209229096888,,"168,90"
20140916,20140911,,,,"-5,60",EUR,,****9021,2140911994,0608,INTERSPAR ARKADY,1609229296992,,"163,30"
20140916,20140913,,,,"-18,10",EUR,,****9021,2140913994,0608,INTERSPAR ARKADY,1609229517737,,"145,20"
20140918,20140918,,,,"-1,20",EUR,,7377373737,140916994,0898,NA LYSINE 772/12,1809229163271,,"144,00"
20140918,20140916,,,,"-36,47",EUR,,****9021,140916994,4559,NA LYSINE 772/12,1809229163270,,"107,53"
20140922,20140919,,,,"-3,23",EUR,,****9021,2140919994,0608,INTERSPAR ARKADY,2209229384931,,"104,30"
20140922,20140918,,,,"-17,21",EUR,,****9021,2140918994,0608,INTERSPAR ARKADY,2209229270321,,"87,09"
20140923,20140923,,,,"-1,20",EUR,,7377373737,140921994,0898,NA LYSINE 772/12,2309229133237,,"85,89"
20140923,20140921,,,,"-43,96",EUR,,****9021,140921994,4559,NA LYSINE 772/12,2309229133236,,"41,93"
20140926,20140926,,,,"-1,20",EUR,,7377373737,140925994,0898,NA LYSINE 772/12,2609229094503,,"40,73"
20140926,20140925,,,,"-36,57",EUR,,****9021,140925994,4559,NA LYSINE 772/12,2609229094502,,"4,16"
20141006,20141006,SK32423749823947823742988,SUBASKBX,adkskjdhkashdkjashd,"400,00",EUR,/VS102014/SS/KS968,102014,,0968,asdasdasdasddasdasd,1410060FSAIBR,,"404,16"
20141009,20141009,,,,"-1,20",EUR,,7377373737,141008994,0898,NA LYSINE 772/12,0910229093440,,"402,96"
20141009,20141008,,,,"-184,14",EUR,,****9021,141008994,4559,NA LYSINE 772/12,0910229093439,,"218,82"
20141013,20141010,,,,"-7,13",EUR,,****9021,2141010994,0608,DM DROGERIE MARKT,1310229291044,,"211,69"
20141013,20141009,,,,"-9,28",EUR,,****9021,2141009994,0608,INTERSPAR ARKADY,1310229282322,,"202,41"
20141013,20141010,,,,"-10,03",EUR,,****9021,2141010994,0608,INTERSPAR ARKADY,1310229400762,,"192,38"
20141014,20141011,,,,"-9,58",EUR,,****9021,2141011994,0608,INTERSPAR ARKADY,1410229068279,,"182,80"
20141017,20141014,,,,"-11,39",EUR,,****9021,2141014994,0608,INTERSPAR ARKADY,1710229103032,,"171,41"
20141020,20141019,SK8394839484939483849384,SUBASKBX,asdasdasdasdasd,"-44,00",EUR,NOTPROVIDED,,,,,141019095RIBR,,"127,41"
20141020,20141017,,,,"-11,44",EUR,,****9021,2141017994,0608,INTERSPAR ARKADY,2010229411268,,"115,97"
20141022,20141022,,,,"-1,20",EUR,,7377373737,141020994,0898,"CS, NAR.TECH.KNIHOVN",2210229078721,,"114,77"
20141022,20141019,,,,"-1,99",EUR,,****9021,2141019994,0608,INTERSPAR ARKADY,2210229094454,,"112,78"
20141022,20141020,,,,"-36,61",EUR,,****9021,141020994,4559,"CS, NAR.TECH.KNIHOVN",2210229078720,,"76,17"
20141024,20141021,,,,"-18,32",EUR,,****9021,2141021994,0608,INTERSPAR ARKADY,2410229090434,,"57,85"
20141027,20141024,,,,"-4,99",EUR,,****9021,2141024994,0608,INTERSPAR ARKADY,2710229371686,,"52,86"
20141027,20141023,,,,"-6,14",EUR,,****9021,2141023994,0608,INTERSPAR ARKADY,2710229257478,,"46,72"
20141028,20141025,,,,"-7,36",EUR,,****9021,2141025994,0608,INTERSPAR ARKADY,2810229138526,,"39,36"
20141029,20141026,,,,"-4,75",EUR,,****9021,2141026994,0608,INTERSPAR ARKADY,2910229092397,,"34,61"
20141031,20141031,SK32423749823947823742988,SUBASKBX,adkskjdhkashdkjashd,"400,00",EUR,/VS112014/SS/KS968,112014,,0968,asdasdasdasddasdasd,1410310VWJIBR,,"434,61"
20141031,20141028,,,,"-9,11",EUR,,****9021,2141028994,0608,INTERSPAR ARKADY,3110229077960,,"425,50"
20141103,20141103,,,,"-1,20",EUR,,7377373737,141030994,0898,"CS, NAR.TECH.KNIHOVN",0311229091743,,"424,30"
20141103,20141029,,,,"-4,56",EUR,,****9021,2141029994,0608,INTERSPAR ARKADY,0311229118861,,"419,74"
20141103,20141030,,,,"-14,64",EUR,,****9021,141030994,4559,"CS, NAR.TECH.KNIHOVN",0311229091742,,"405,10"
20141105,20141105,,,,"-1,20",EUR,,7377373737,141104994,0898,NA LYSINE 772/12,0511229089577,,"403,90"
20141105,20141104,,,,"-145,18",EUR,,****9021,141104994,4559,NA LYSINE 772/12,0511229089576,,"258,72"
20141106,20141104,,,,"-9,42",EUR,,****9021,2141104994,0608,SDI MUZEUM,0611229084487,,"249,30"
20141110,20141107,,,,"-8,25",EUR,,****9021,2141107994,0608,"STUDENT AGENCY, K.S.",1011229362424,,"241,05"
20141110,20141106,,,,"-16,49",EUR,,****9021,2141106994,0608,"STUDENT AGENCY, K.S.",1011229362396,,"224,56"
20141110,20141106,,,,"-39,11",EUR,,****9021,2141106994,0608,SPAR 829,1011229120302,,"185,45"
20141118,20141114,,,,"-2,37",EUR,,****9021,2141114994,0608,TESCO PRAHA 4-NUSLE,1811229444592,,"183,08"
20141120,20141118,,,,"-12,63",EUR,,****9021,2141118994,0608,SPAR 829,2011229261027,,"170,45"
20141121,20141118,,,,"-4,16",EUR,,****9021,2141118994,0608,TESCO PRAHA 4-NUSLE,2111229096934,,"166,29"
20141124,20141124,,,,"-1,20",EUR,,7377373737,141120994,0898,"S6CY PHA 7,ALZASOFT",2411229125488,,"165,09"
20141124,20141120,,,,"-72,84",EUR,,****9021,141120994,4559,"S6CY PHA 7,ALZASOFT",2411229125487,,"92,25"
20141125,20141123,,,,"-13,19",EUR,,****9021,2141123994,0608,SPAR 829,2511229176987,,"79,06"
20141127,20141125,,,,"-13,08",EUR,,****9021,2141125994,0608,E-VOLVE MOLESKINE,2711229066245,,"65,98"
20141128,20141126,,,,"-14,88",EUR,,****9021,2141126994,0608,SPAR 829,2811229113032,,"51,10"
20141201,20141201,SK32423749823947823742988,SUBASKBX,adkskjdhkashdkjashd,"400,00",EUR,/VS122014/SS/KS968,122014,,0968,asdasdasdasddasdasd,14120102H8IBR,,"451,10"
20141201,20141126,,,,"-8,28",EUR,,****9021,2141126994,0608,"STUDENT AGENCY, K.S.",0112229100690,,"442,82"
20141204,20141202,,,,"-6,43",EUR,,****9021,2141202994,0608,SPAR 829,0412229112052,,"436,39"
20141204,20141201,,,,"-8,10",EUR,,****9021,2141201334,0608,"STUDENT AGENCY, K.S.",0412229089859,,"428,29"
20141211,20141211,,,,"-1,20",EUR,,7377373737,141209994,0898,NA LYSINE 772/12,1112229115203,,"427,09"
20141211,20141209,,,,"-20,67",EUR,,****9021,2141209994,0608,SPAR 829,1112229126592,,"406,42"
20141211,20141209,,,,"-146,37",EUR,,****9021,141209994,4559,NA LYSINE 772/12,1112229115202,,"260,05"
20141215,20141212,,,,"-16,85",EUR,,****9021,2141212994,0608,SPAR 829,1512229343725,,"243,20"
20141218,20141216,,,,"-10,04",EUR,,****9021,2141216994,0608,SPAR 829,1812229128694,,"233,16"
20141222,20141220,SK8394839484939483849384,SUBASKBX,asdasdasdasdasd,"-62,00",EUR,NOTPROVIDED,,,,,141220052NIBR,,"171,16"
20141222,20141222,,,,"-1,20",EUR,,7377373737,141219994,0898,NA LYSINE 772/12,2212229309358,,"169,96"
20141222,20141218,,,,"-3,86",EUR,,****9021,2141218994,0608,TESCO PRAHA 4-NUSLE,2212229304118,,"166,10"
20141222,20141220,,,,"-8,74",EUR,,****9021,2141220994,0608,Nanu-Nana,2212229426414,,"157,36"
20141222,20141219,,,,"-36,43",EUR,,****9021,141219994,4559,NA LYSINE 772/12,2212229309357,,"120,93"
20141223,20141220,,,,"-8,80",EUR,,****9021,2141220334,0608,ZELEZNICNA SPOL  SLO,2312229189882,,"112,13"
20141229,20141222,,,,"-11,98",EUR,,****9021,2141222334,0608,"DRACIK,LM,KAMENNE PO",2912229078113,,"100,15"
20141231,20141228,,,,"-31,30",EUR,,****9021,2141228994,0608,LEO EXPRESS,3112229096551,,"68,85"
20150105,20150102,,,,"-9,22",EUR,,****9021,2150102994,0608,SPAR 829,0501229169277,,"59,63"
20150105,20150101,,,,"-13,78",EUR,,****9021,2150101994,0608,CINEMA CITY CZECH,0501229161596,,"45,85"
20150107,20150107,SK32423749823947823742988,SUBASKBX,adkskjdhkashdkjashd,"400,00",EUR,/VS12015/SS/KS968,12015,,0968,asdasdasdasddasdasd,1501070JJVIBR,,"445,85"
20150107,20150107,,,,"-1,20",EUR,,7377373737,150104994,0898,UNICREDIT - PRAHA 3,0701229147414,,"444,65"
20150107,20150103,,,,"-4,60",EUR,,****9021,2150103994,0608,TESCO PRAHA 4-NUSLE,0701229114076,,"440,05"
20150107,20150104,,,,"-36,45",EUR,,****9021,150104994,4559,UNICREDIT - PRAHA 3,0701229147413,,"403,60"
20150109,20150109,,,,"-1,20",EUR,,7377373737,150107994,0898,UNICREDIT - PRAHA 3,0901229110340,,"402,40"
20150109,20150107,,,,"-9,50",EUR,,****9021,2150107994,0608,SDI MUZEUM,0901229083598,,"392,90"
20150109,20150107,,,,"-19,51",EUR,,****9021,2150107994,0608,SPAR 829,0901229102383,,"373,39"
20150109,20150107,,,,"-109,60",EUR,,****9021,150107994,4559,UNICREDIT - PRAHA 3,0901229110339,,"263,79"
20150112,20150109,,,,"-13,18",EUR,,****9021,2150109994,0608,SPAR 829,1201229250800,,"250,61"
20150112,20150110,,,,"-17,18",EUR,,****9021,2150110994,0608,SPAR 829,1201229348108,,"233,43"
20150114,20150114,,,,"-1,20",EUR,,7377373737,150113994,0898,NA LYSINE 772/12,1401229106971,,"232,23"
20150114,20150113,,,,"-71,48",EUR,,****9021,150113994,4559,NA LYSINE 772/12,1401229106970,,"160,75"
20150119,20150117,,,,"-9,66",EUR,,****9021,2150117994,0608,DAMEJIDLO.CZ,1901229411605,,"151,09"
20150126,20150122,,,,"-28,26",EUR,,****9021,2150122994,0608,SPAR 829,2601229121111,,"122,83"
20150129,20150127,,,,"-16,82",EUR,,****9021,2150127994,0608,SPAR 829,2901229104470,,"106,01"
20150202,20150129,,,,"-3,44",EUR,,****9021,2150129994,0608,SPAR 829,0202229111824,,"102,57"
20150202,20150131,,,,"-4,94",EUR,,****9021,2150131994,0608,ALBERT HM 0198,0202229341778,,"97,63"
20150202,20150128,,,,"-10,00",EUR,,****9021,2150128334,0608,STEAMGAMES.COM,0202229036129,,"87,63"
20150203,20150203,,,,"-1,20",EUR,,7377373737,150130994,0898,THAKUROVA 7 - CVUT,0302229127405,,"86,43"
20150203,20150201,,,,"-14,82",EUR,,****9021,2150201994,0608,SPAR 829,0302229131640,,"71,61"
20150203,20150130,,,,"-36,29",EUR,,****9021,150130994,4559,THAKUROVA 7 - CVUT,0302229127404,,"35,32"
20150204,20150204,SK32423749823947823742988,SUBASKBX,adkskjdhkashdkjashd,"400,00",EUR,/VS22015/SS/KS968,22015,,0968,asdasdasdasddasdasd,1502040J67IBR,,"435,32"
20150204,20150129,,,,"-6,24",EUR,,****9021,2150129334,0608,STEAMGAMES.COM,0402229092184,,"429,08"
20150205,20150203,,,,"-9,86",EUR,,****9021,2150203994,0608,ALBERT HM 0829,0502229101799,,"419,22"
20150205,20150203,,,,"-10,59",EUR,,****9021,2150203994,0608,DAMEJIDLO.CZ,0502229093005,,"408,63"
20150206,20150204,,,,"-15,67",EUR,,****9021,2150204994,0608,ALBERT HM 0829,0602229102534,,"392,96"
20150209,20150206,,,,"12,81",EUR,,****9021,2150206994,0608,E-VOLVE MOLESKINE,0902229290230,,"405,77"
20150209,20150206,,,,"-7,61",EUR,,****9021,2150206994,0608,ALBERT HM 0829,0902229274739,,"398,16"
20150209,20150206,,,,"-9,51",EUR,,****9021,2150206994,0608,SDI MUZEUM,0902229259169,,"388,65"
20150209,20150207,,,,"-11,96",EUR,,****9021,2150207994,0608,DAMEJIDLO.CZ,0902229370171,,"376,69"
20150210,20150208,,,,"-12,73",EUR,,****9021,2150208994,0608,DAMEJIDLO.CZ,1002229126016,,"363,96"
20150211,20150209,,,,"-11,29",EUR,,****9021,2150209994,0608,DAMEJIDLO.CZ,1102229102268,,"352,67"
20150212,20150210,,,,"-13,39",EUR,,****9021,2150210994,0608,DAMEJIDLO.CZ,1202229109055,,"339,28"
20150213,20150211,,,,"-4,18",EUR,,****9021,2150211994,0608,LEKARNA STUDENTSKY D,1302229117719,,"335,10"
20150213,20150211,,,,"-10,60",EUR,,****9021,2150211994,0608,DAMEJIDLO.CZ,1302229114439,,"324,50"
20150216,20150216,,,,"-1,20",EUR,,7377373737,150212994,0898,NA LYSINE 772/12,1602229131336,,"323,30"
20150216,20150213,,,,"-16,70",EUR,,****9021,2150213994,0608,ALBERT HM 0829,1602229335379,,"306,60"
20150216,20150212,,,,"-145,80",EUR,,****9021,150212994,4559,NA LYSINE 772/12,1602229131335,,"160,80"
20150217,20150215,,,,"-10,66",EUR,,****9021,2150215994,0608,ALBERT HM 0829,1702229162997,,"150,14"
20150219,20150217,,,,"-11,72",EUR,,****9021,2150217994,0608,DAMEJIDLO.CZ,1902229109374,,"138,42"
20150220,20150218,,,,"-11,64",EUR,,****9021,2150218994,0608,ALBERT HM 0829,2002229114996,,"126,78"
20150223,20150219,,,,"-7,76",EUR,,****9021,2150219994,0608,DAMEJIDLO.CZ,2302229120175,,"119,02"
20150223,20150220,,,,"-15,20",EUR,,****9021,2150220994,0608,ALBERT HM 0829,2302229303736,,"103,82"
20150224,20150222,,,,"-11,75",EUR,,****9021,2150222994,0608,DAMEJIDLO.CZ,2402229131796,,"92,07"
20150225,20150222,,,,"-12,70",EUR,,****9021,2150222334,0608,"STUDENT AGENCY, K.S.",2502229098465,,"79,37"
20150303,20150228,,,,"-15,81",EUR,,****9021,2150228994,0608,LEO EXPRESS,0303229112021,,"63,56"
20150305,20150305,SK32423749823947823742988,SUBASKBX,adkskjdhkashdkjashd,"400,00",EUR,/VS32015/SS/KS968,32015,,0968,asdasdasdasddasdasd,15030514U8IBR,,"463,56"
20150305,20150305,,,,"-1,20",EUR,,7377373737,150303994,0898,NA LYSINE 772/12,0503229097430,,"462,36"
20150305,20150303,,,,"-44,05",EUR,,****9021,150303994,4559,NA LYSINE 772/12,0503229097429,,"418,31"
20150309,20150305,,,,"-22,04",EUR,,****9021,2150305994,0608,ALBERT HM 0829,0903229124914,,"396,27"
20150310,20150310,,,,"-1,20",EUR,,7377373737,150308994,0898,"S6CY PRAHA 3, PALAC",1003229144583,,"395,07"
20150310,20150308,,,,"-10,53",EUR,,****9021,2150308994,0608,ALBERT HM 0829,1003229146844,,"384,54"
20150310,20150308,,,,"-36,97",EUR,,****9021,150308994,4559,"S6CY PRAHA 3, PALAC",1003229144582,,"347,57"
20150311,20150309,,,,"-7,89",EUR,,****9021,2150309994,0608,Tesco Praha 4-Nusle,1103229144684,,"339,68"
20150311,20150307,,,,"-9,61",EUR,,****9021,2150307994,0608,SDI MUZEUM,1103229145946,,"330,07"
20150311,20150307,,,,"-11,39",EUR,,****9021,2150307994,0608,CINEMA CITY CZECH,1103229154136,,"318,68"
20150312,20150310,,,,"-6,99",EUR,,****9021,2150310994,0608,Tesco Praha 4-Nusle,1203229106349,,"311,69"
20150313,20150313,,,,"-1,20",EUR,,7377373737,150311994,0898,NA LYSINE 772/12,1303229114395,,"310,49"
20150313,20150311,,,,"-9,28",EUR,,****9021,2150311994,0608,Tesco Praha 4-Nusle,1303229109402,,"301,21"
20150313,20150311,,,,"-184,66",EUR,,****9021,150311994,4559,NA LYSINE 772/12,1303229114394,,"116,55"
20150316,20150312,,,,"-16,90",EUR,,****9021,2150312994,0608,ALBERT HM 0829,1603229141913,,"99,65"
20150323,20150321,,,,"-8,17",EUR,,****9021,2150321994,0608,ALBERT HM 0829,2303229439749,,"91,48"
20150323,20150319,,,,"-9,98",EUR,,****9021,2150319994,0608,ALBERT HM 0829,2303229137639,,"81,50"
20150324,20150322,,,,"-13,95",EUR,,****9021,2150322994,0608,DAMEJIDLO.CZ,2403229139940,,"67,55"
20150327,20150325,,,,"-6,13",EUR,,****9021,2150325994,0608,ALBERT HM 0829,2703229116445,,"61,42"
20150401,20150330,,,,"-6,97",EUR,,****9021,2150330994,0608,ALBERT HM 0829,0104229115449,,"54,45"
20150402,20150402,SK32423749823947823742988,SUBASKBX,adkskjdhkashdkjashd,"400,00",EUR,/VS42015/SS/KS968,42015,,0968,asdasdasdasddasdasd,15040210F5IBR,,"454,45"
20150402,20150331,,,,"-12,34",EUR,,****9021,2150331994,0608,ALBERT HM 0829,0204229118530,,"442,11"
20150407,20150407,,,,"-1,20",EUR,,7377373737,150402994,0898,"CS, NAR.TECH.KNIHOVN",0704229268158,,"440,91"
20150407,20150404,,,,"-4,34",EUR,,****9021,2150404994,0608,PEPA.CZ,0704229523630,,"436,57"
20150407,20150403,,,,"-15,50",EUR,,****9021,2150403994,0608,ALBERT HM 0829,0704229440422,,"421,07"
20150407,20150404,,,,"-21,19",EUR,,****9021,2150404994,0608,CINEMA CITY CZECH,0704229523640,,"399,88"
20150407,20150402,,,,"-36,78",EUR,,****9021,150402994,4559,"CS, NAR.TECH.KNIHOVN",0704229268157,,"363,10"
20150408,20150406,,,,"-10,10",EUR,,****9021,2150406994,0608,ALBERT HM 0829,0804229100140,,"353,00"
20150413,20150413,,,,"-1,20",EUR,,7377373737,150409994,0898,NA LYSINE 772/12,1304229122350,,"351,80"
20150413,20150409,,,,"-10,93",EUR,,****9021,2150409994,0608,ALBERT HM 0829,1304229133087,,"340,87"
20150413,20150408,,,,"-26,67",EUR,,****9021,2150408994,0608,SDI HLAVNI NADRAZI,1304229104060,,"314,20"
20150413,20150409,,,,"-148,18",EUR,,****9021,150409994,4559,NA LYSINE 772/12,1304229122349,,"166,02"
20150415,20150413,,,,"-16,74",EUR,,****9021,2150413994,0608,ALBERT HM 0829,1504229130388,,"149,28"
20150417,20150417,,,,"-1,20",EUR,,7377373737,150415994,0898,NA LYSINE 772/12,1704229123422,,"148,08"
20150417,20150414,,,,"-16,20",EUR,,****9021,2150414334,0608,"STUDENT AGENCY, K.S.",1704229118734,,"131,88"
20150417,20150415,,,,"-37,06",EUR,,****9021,150415994,4559,NA LYSINE 772/12,1704229123421,,"94,82"
20150420,20150416,,,,"-6,82",EUR,,****9021,2150416994,0608,Tesco Praha 4-Nusle,2004229129323,,"88,00"
20150420,20150417,,,,"-15,44",EUR,,****9021,2150417994,0608,LIDL369,2004229318104,,"72,56"
20150421,20150419,,,,"-11,53",EUR,,****9021,2150419994,0608,ALBERT HM 0829,2104229115283,,"61,03"
20150424,20150424,,,,"-1,20",EUR,,7377373737,150422994,0898,"CS, CENTROTEX",2404229087150,,"59,83"
20150424,20150422,,,,"-36,88",EUR,,****9021,150422994,4559,"CS, CENTROTEX",2404229087149,,"22,95"
20150430,20150428,,,,"-10,43",EUR,,****9021,2150428994,0608,DAMEJIDLO.CZ,3004229106718,,"12,52"
20150504,20150504,SK32423749823947823742988,SUBASKBX,adkskjdhkashdkjashd,"400,00",EUR,/VS52015/SS/KS968,52015,,0968,asdasdasdasddasdasd,1505041B8MIBR,,"412,52"
20150504,20150429,,,,"-2,63",EUR,,****9021,2150429994,0608,Tesco Praha 4-Nusle,0405229112892,,"409,89"
20150507,20150505,,,,"-18,15",EUR,,****9021,2150505994,0608,ALBERT HM 0829,0705229122926,,"391,74"
20150507,20150504,,,,"-36,54",EUR,,****9021,2150504994,0608,LEO EXPRESS,0705229102516,,"355,20"
20150511,20150511,,,,"-1,20",EUR,,7377373737,150508994,0898,"CS, OC ARKADY",1105229456806,,"354,00"
20150511,20150506,,,,"-5,49",EUR,,****9021,2150506994,0608,ALBERT HM 0829,1105229131121,,"348,51"
20150511,20150507,,,,"-10,07",EUR,,****9021,2150507994,0608,ALBERT HM 0829,1105229326658,,"338,44"
20150511,20150508,,,,"-12,51",EUR,,****9021,2150508994,0608,ALBERT HM 0829,1105229486284,,"325,93"
20150511,20150508,,,,"-147,74",EUR,,****9021,150508994,4559,"CS, OC ARKADY",1105229456805,,"178,19"
20150513,20150510,,,,"-21,60",EUR,,****9021,2150510334,0608,"STUDENT AGENCY, K.S.",1305229118839,,"156,59"
20150513,20150510,,,,"-21,60",EUR,,****9021,2150510334,0608,"STUDENT AGENCY, K.S.",1305229118841,,"134,99"
20150518,20150517,SK32423749823947823742988,SUBASKBX,adkskjdhkashdkjashd,"100,00",EUR,/VS515/SS/KS968,515,,0968,asdasdasdasddasdasd,1505170U3YIBR,,"234,99"
20150518,20150516,,,,"-1,58",EUR,,****9021,2150516334,0608,BILLA  SPOL  S R O,1805229450495,,"233,41"
20150518,20150516,,,,"-20,70",EUR,,****9021,2150516334,0608,FANY FLORA  S R O,1805229482203,,"212,71"
20150518,20150515,,,,"-69,00",EUR,,****9021,2150515334,0608,OZETA,1805229210014,,"143,71"
20150519,20150516,,,,"21,60",EUR,,****9021,2150516334,0608,"STUDENT AGENCY, K.S.",1905229187750,,"165,31"
20150519,20150515,,,,"-22,88",EUR,,****9021,2150515334,0608,"MAMUT PUB, BA, CINTO",1905229057360,,"142,43"
20150521,20150519,,,,"-9,49",EUR,,****9021,2150519994,0608,ALBERT HM 0829,2105229126380,,"132,94"
20150525,20150523,,,,"-12,92",EUR,,****9021,2150523994,0608,SLEVOMAT CZ,2505229431695,,"120,02"
20150529,20150527,,,,"-10,55",EUR,,****9021,2150527994,0608,ALBERT HM 0829,2905229119537,,"109,47"
20150601,20150529,,,,"-10,46",EUR,,****9021,2150529994,0608,DAMEJIDLO.CZ,0106229301967,,"99,01"
20150601,20150530,,,,"-10,46",EUR,,****9021,2150530994,0608,DAMEJIDLO.CZ,0106229418225,,"88,55"
20150602,20150602,SK32423749823947823742988,SUBASKBX,adkskjdhkashdkjashd,"400,00",EUR,/VS515/SS/KS968,515,,0968,asdasdasdasddasdasd,15060219TOIBR,,"488,55"
20150602,20150602,,,,"-1,20",EUR,,7377373737,150531994,0898,"CS, CENTROTEX",0206229084352,,"487,35"
20150602,20150531,,,,"-11,64",EUR,,****9021,2150531994,0608,DAMEJIDLO.CZ,0206229100994,,"475,71"
20150602,20150531,,,,"-36,97",EUR,,****9021,150531994,4559,"CS, CENTROTEX",0206229084351,,"438,74"
20150604,20150602,,,,"-5,54",EUR,,****9021,2150602994,0608,Tesco Praha 4-Nusle,0406229085332,,"433,20"
20150605,20150603,,,,"-10,44",EUR,,****9021,2150603994,0608,ALBERT HM 0829,0506229137849,,"422,76"
20150608,20150608,,,,"-1,20",EUR,,7377373737,150605994,0898,161 00 Aviaticka,0806229125015,,"421,56"
20150608,20150604,,,,"-9,24",EUR,,****9021,2150604994,0608,DAMEJIDLO.CZ,0806229125170,,"412,32"
20150608,20150605,,,,"-147,90",EUR,,****9021,150605994,4559,161 00 Aviaticka,0806229125014,,"264,42"
20150609,20150607,,,,"-15,20",EUR,,****9021,2150607994,0608,DAMEJIDLO.CZ,0906229138088,,"249,22"
20150611,20150605,,,,"-2,29",EUR,,****9021,2150605994,0608,AUSTRIAN AIRLINES,1106229075963,,"246,93"
20150611,20150609,,,,"-20,91",EUR,,****9021,2150609994,0608,DAMEJIDLO.CZ,1106229120082,,"226,02"
20150618,20150616,,,,"-34,60",EUR,,****9021,2150616994,0608,ALBERT HM 0829,1806229140743,,"191,42"
20150622,20150620,,,,"-4,82",EUR,,****9021,2150620994,0608,BAUHAUS k.s. 883,2206229432780,,"186,60"
20150622,20150618,,,,"-18,15",EUR,,****9021,2150618994,0608,ALBERT HM 0829,2206229144028,,"168,45"
20150630,20150628,,,,"-14,68",EUR,,****9021,2150628994,0608,ALBERT HM 0829,3006229146567,,"153,77"
20150701,20150627,,,,"-14,30",EUR,,****9021,2150627994,0608,ALBERT HM 0829,0107229126615,,"139,47"
20150706,20150704,,,,"-9,55",EUR,,****9021,2150704994,0608,ALBERT HM 0829,0607229427526,,"129,92"
20150710,20150707,,,,"18,00",EUR,,****9021,2150707334,0608,"STUDENT AGENCY, K.S.",1007229148941,,"147,92"
20150710,20150707,,,,"-18,00",EUR,,****9021,2150707334,0608,"STUDENT AGENCY, K.S.",1007229112792,,"129,92"
20150713,20150710,,,,"-20,00",EUR,,****9021,2150710334,0608,SLOVNAFT  A S,1307229327168,,"109,92"
20150713,20150710,,,,"-28,63",EUR,,****9021,2150710334,0608,DM LIPTOVSK� MIKUL��,1307229046043,,"81,29"
20150715,20150709,,,,"-10,99",EUR,,****9021,2150709334,0608,STEAMGAMES.COM,1507229118537,,"70,30"
20150720,20150716,,,,"-8,44",EUR,,****9021,2150716994,0608,"STUDENT AGENCY, K.S.",2007229322963,,"61,86"
20150721,20150719,,,,"-13,00",EUR,,****9021,2150719994,0608,USCUSTOMS ESTA APPL,2107229116681,,"48,86"
20150724,20150724,CZ2620100000002200828450,FIOBCZPPXXX,David Zaludek,"780,00",EUR,NOTPROVIDED,,,,,7700413406,,"828,86"
20150724,20150722,,,,"-5,43",EUR,,****9021,2150722994,0608,SLEVOMAT CZ,2407229104946,,"823,43"
20150727,20150724,,,,"-4,99",EUR,,****9021,2150724994,0608,DAMEJIDLO.CZ,2707229385654,,"818,44"
20150727,20150723,,,,"-11,15",EUR,,****9021,2150723994,0608,ALZA.CZ,2707229185735,,"807,29"
20150727,20150724,,,,"-726,08",EUR,,****9021,2150724994,0608,DELTA AIR   00623160,2707229468381,,"81,21"
20150728,20150726,,,,"-9,91",EUR,,****9021,2150726994,0608,DAMEJIDLO.CZ,2807229138203,,"71,30"
20150803,20150801,,,,"-22,27",EUR,,****9021,2150801994,0608,SLEVOMAT CZ,0308229414145,,"49,03"
20150803,20150730,,,,"-39,99",EUR,,****9021,2150730334,0608,BLIZZARD ENTERTAINME,0308229225412,,"9,04"
20150820,20150818,,,,"-4,43",EUR,,****9021,2150818994,0608,SLEVOMAT CZ,2008229128059,,"4,61"
20150831,20150831,SK32423749823947823742988,SUBASKBX,adkskjdhkashdkjashd,"400,00",EUR,/VS92015/SS/KS968,92015,,0968,asdasdasdasddasdasd,150831148RIBR,,"404,61"
20150923,20150920,,,,"-10,99",EUR,,****9021,2150920334,0608,STEAMGAMES.COM,2309229039626,,"393,62"
20150924,20150921,,,,"-3,91",EUR,,****9021,2150921994,0608,ARAMARK UNIV OF TN M,2409229042614,,"389,71"
20150924,20150921,,,,"-8,88",EUR,,****9021,2150921994,0608,ARAMARK UNIV OF TN C,2409229042615,,"380,83"
20150924,20150922,,,,"-18,00",EUR,,****9021,2150922334,0608,www.ecolines.net,2409229074863,,"362,83"
20150925,20150925,,,,"-1,20",EUR,,7377373737,150924994,0898,S6CY PHA4 METRO PRAZ,2509229105680,,"361,63"
20150925,20150924,,,,"-185,80",EUR,,****9021,150924994,4559,S6CY PHA4 METRO PRAZ,2509229105679,,"175,83"
20150929,20150927,,,,"-26,34",EUR,,****9021,2150927994,0608,MAKRO 05,2909229137521,,"149,49"
20151001,20151001,,,,"-1,20",EUR,,7377373737,150929994,0898,"S6CY PHA 7,ALZASOFT",0110229117879,,"148,29"
20151001,20150929,,,,"-36,87",EUR,,****9021,150929994,4559,"S6CY PHA 7,ALZASOFT",0110229117878,,"111,42"
20151002,20150930,,,,"-8,50",EUR,,****9021,2150930994,0608,MOBIL.CZ,0210229146598,,"102,92"
20151002,20150930,,,,"-19,88",EUR,,****9021,2150930994,0608,ALBERT HM 0829,0210229157328,,"83,04"
20151022,20151018,,,,"-10,51",EUR,,****9021,2151018334,0608,STEAMGAMES.COM,2210229112338,,"72,53"
20151023,20151023,,,,"-1,20",EUR,,7377373737,151022994,0898,S6CY PHA4 METRO PRAZ,2310229127276,,"71,33"
20151023,20151022,,,,"-55,70",EUR,,****9021,151022994,4559,S6CY PHA4 METRO PRAZ,2310229127275,,"15,63"
20151201,20151129,,SUBASKBXXXX,"VUB,EVIDENCNE UCTY ODBORU 4400","-11,99",EUR,/VS7377373737/SS2151129334/KS0608,****9021,2151129334,0608,DDPLAYSTATIONNETWORK  4333000000,0112229041814,,"3,64"
20151207,20151207,SK7111000000002629006716,TATRSKBXXXX,"N I K � , spol. s r.","2 612,00",EUR,/VS6423153/SS/KS558,6423153,,0558,6423153,OP15120400429,,"2 615,64"
20151209,20151208,,SUBASKBXXXX,"VUB,EU ODBORU 4200","-700,00",EUR,/VS7377373737/SS2151208334/KS0608,****9021,2151208334,0608,DDIFORTUNA.SK         4333153807,0912229189624,,"1 915,64"
20151231,20151231,,,,"0,01",EUR,,9,,0598,Kreditn� �rok-vyplatenie,3112IG0064300,,"1 915,65"
20160118,20160118,SK7511000000002625107923,TATRSKBXXXX,"FORTUNA SK, a.s.","2 326,00",EUR,/VS7874342/SS/KS308,7874342,,0308,,OP16011500163,,"4 241,65"
20160129,20160131,,,,"0,02",EUR,,9,,0598,Kreditn� �rok-vyplatenie,2901IG0063674,,"4 241,67"
20160229,20160229,,,,"0,03",EUR,,9,,0598,Kreditn� �rok-vyplatenie,2902IG0064720,,"4 241,70"
20160311,20160309,,SUBASKBXXXX,"VUB,EVIDENCNE UCTY ODBORU 4400","-86,03",EUR,/VS7377373737/SS2160309994/KS0608,****9021,2160309994,0608,DDALZA SHOWROOM       4333000000,1103229134019,,"4 155,67"
20160331,20160331,,,,"0,03",EUR,,9,,0598,Kreditn� �rok-vyplatenie,3103IG0064846,,"4 155,70"
20160429,20160430,,,,"0,03",EUR,,9,,0598,Kreditn� �rok-vyplatenie,2904IG0064020,,"4 155,73"
20160509,20160507,,SUBASKBXXXX,"VUB,EU ODBORU 4200","-50,00",EUR,/VS0015674373/SS1160507334/KS4559,****4373,1160507334,4559,DDATM342G LM-STOPSHOP 4595191901,0905229382540,,"4 105,73"
20160531,20160531,,,,"0,03",EUR,,9,,0598,Kreditn� �rok-vyplatenie,3105IG0063580,,"4 105,76"
20160630,20160630,,,,"0,03",EUR,,9,,0598,Kreditn� �rok-vyplatenie,3006IG0063557,,"4 105,79"
20160729,20160731,,,,"0,03",EUR,,9,,0598,Kreditn� �rok-vyplatenie,2907IG0062801,,"4 105,82"
20161227,20161222,,SUBASKBXXXX,"VUB,EVIDENCNE UCTY ODBORU 4400","-545,88",EUR,/VS0015674373/SS2161222334/KS0608,****4373,2161222334,0608,DDNAY ELEKTRODOM LM   4595000000,2712229085317,,"3 559,94"
20170206,20170204,,SUBASKBXXXX,"VUB,EVIDENCNE UCTY ODBORU 4400","-26,07",EUR,/VS0015674373/SS2170204994/KS0608,****4373,2170204994,0608,DDQUIKSILVER PRAHA ARK4595000000,0602229438676,,"3 533,87"
20170206,20170204,,SUBASKBXXXX,"VUB,EVIDENCNE UCTY ODBORU 4400","-217,22",EUR,/VS0015674373/SS2170204994/KS0608,****4373,2170204994,0608,DDQUIKSILVER PRAHA ARK4595000000,0602229438677,,"3 316,65"
